64
20 20
400 200
2
world1_bg 10 10
world2_bg 3 3
2 2 2 2 2 2 2 2 2 2 2 2 2 2 2 2 2 2 2 2
2 1 3 3 3 3 3 3 3 3 3 3 3 3 3 3 3 3 1 2
2 1 3 2 2 2 2 1 1 1 3 3 3 3 3 3 3 3 1 2
2 1 3 3 3 3 3 3 3 3 3 3 3 3 3 3 3 3 1 2
2 1 3 3 1 1 1 1 1 3 3 3 3 3 3 3 3 3 1 2
2 1 3 3 2 2 2 2 1 3 3 3 3 3 3 3 3 3 1 2
2 1 3 3 3 3 3 3 3 3 3 3 3 3 3 3 3 3 1 2
2 1 3 3 2 2 2 2 1 2 3 3 3 3 3 3 3 3 1 2
2 1 3 3 3 3 3 2 3 2 3 3 3 3 3 3 3 3 1 2
2 1 3 3 3 3 3 2 1 2 3 3 3 3 3 3 3 3 1 2
2 1 3 3 3 3 3 2 3 2 3 3 3 3 3 3 3 3 1 2
2 1 3 3 3 3 3 3 3 3 3 3 3 3 3 3 3 3 1 2
2 1 3 3 3 3 3 3 3 3 3 3 3 3 3 3 3 3 1 2
2 1 3 3 3 3 3 3 3 3 3 3 3 3 3 3 3 3 1 2
2 1 3 3 3 3 3 3 3 3 3 3 3 3 3 3 3 3 1 2
2 1 3 3 3 3 3 3 3 3 3 3 3 3 3 3 3 3 1 2
2 1 3 3 3 3 3 3 3 3 3 3 3 3 3 3 3 3 1 2
2 1 3 3 3 3 3 3 3 3 3 3 3 3 3 3 3 3 1 2
2 1 3 3 3 3 3 3 3 3 3 3 3 3 3 3 3 3 1 2
2 2 2 2 2 2 2 2 2 2 2 2 2 2 2 2 2 2 2 2